################................................................################
#..............................................................................#
#..............................................................................#
#..............................................................................#
#..............................................................................#
#..............................................................................#
#..............................................................................#
#...................................#########..................................#
......................................#####.....................................
......................................#####.....................................
......................................#####.....................................
......................................#####.....................................
.....................#................#####...............#.....................
.....................######################################.....................
.....................######################################.....................
.....................######################################.....................
.....................######################################.....................
.....................#................#####...............#.....................
......................................#####.....................................
......................................#####.....................................
......................................#####.....................................
......................................#####.....................................
#...................................#########..................................#
#..............................................................................#
#..............................................................................#
#..............................................................................#
#..............................................................................#
#..............................................................................#
#..............................................................................#
################................................................################